   NO        ../texture/mossy.xpm
WE ../texture/greystone.xpm
SO ../texture/bluestone.xpm
EA ../texture/redbrick.xpm
C    10,10,255
R    800 800
F    224,224,224
S ../texture/barrel.xpm

        111111111111111111111111
        1000000000110000000000001
        1011000001110000002000001
        1001000000000000000000001
111111111011000001110000000000001
100000000011000001110111111111111
11110111111111011100000010001  
11111111111111111111111111111
1   1                       1
111111111111111111111111111
100200N002000001100100001001
10000020000000001101000010001
110200011210101110001110001111
11110111 1110101 101111010001
11111111 1111111 111111111111
