NO        ../texture/mossy.xpm      
SO ../texture/bluestone.xpm
WE ../texture/greystone.xpm
EA ../texture/redbrick.xpm
S ../texture/barrel.xpm
C  10,10,10
R    800 800
F    224,224,224 

        1111111111111111111111111
        1000000000110000000000001
        1011000001110000002000001
        1001000000000000000000001
111111111011000001110000000000001
100000000011000001110111111111111
11110111111111011100000010001    
11110111111111011101010010001
11000000110101011100000010001
100020N0000000011001000010001
10000000000000001101000010001
11000001110101011110001110001111
11110111 1110101 101111010001
11111111 1111111 111111111111