C  42,224,254
F    224,224,224
WE      ../texture/greystone.xpm
EA      ../texture/redbrick.xpm
S    ../texture/barrel.xpm


R  1000   1000
NO          ../texture/mossy.xpm
SO         ../texture/bluestone.xpm


  11111111111
 1200000000001
 1200000000001
 1200000000001
 1200000000001
 1200000000001
10000W00000001
 1111111111111
